0A
OOOOOOOOOO
OXOOXOOOOO
OXOOXOOOOO
OOOOOOXOOO
OOOOOOXOOO
OOOXOOOOOO
OXOXXOCOOO
OXOOOOOOOO
OOOOXXXOOO
OOOOOOOOOO
