0A
OOOODDOOOS
OXOOXOOOXX
OXOOXOOOOO
OXOOOOXOOO
XXOOOOXXXO
OOOXOOOOOO
OXOXXOCXOO
OXOOOOOOXX
OOOOXXXOOO
JOOOOXOOOO
