0c
OOOOOOOOOSOO
OXOOXOOOOOOO
OXOOXOOOOOOO
OOOOOOXOOOOO
OOOOOOXOOOOO
OOOXOOOOOOOO
OXOXXOCOOOOO
OXOOOOOOOOOO
OOOOXXXOOOOO
JOOOOOOOOOOO
JOOOOOOOOOOO
JOOOOOOOOOOO