0A
OOOOOOOOOS
OXOOXOOOOO
OXOOXOOOOO
OOOOOOXOOO
OOOOOOXOOO
OOOXOOOOOO
OXOXXOCOOO
OXOOOOOOOO
OOOOXXXOOO
JOOOOOOOOO
